type octile
height 20
width 40
MapTeste
@@@@@@@@@@@@@@@@@@@@@@@@@@@@@@@@@@@@@@@@
@................@@@@..................@
@...@@@@......@@@@@@@@@@@@.............@
@.....@@@@@.......@@@@@........@@@@@...@
@....@@@@@@.....@@@....................@
@......@@@@@..@@@@@@@@@.......@@@@@....@
@......@@@@@............@@@............@
@........@@...@@@@@@@@@................@
@..@@@........@@@@@@@@@.@.......@@@....@
@..@@@@@@@.........@@@@@@...@@@@@@@....@
@.@@@@@......@@@.......................@
@..@@@@@@....@@@........@@@@@@.........@
@..@@@@@....@@@@@@@@.......@@@@@.......@
@.@@@@@...@............@@@@@...........@
@@......@@@@@...............@@@@@@@....@
@...@@...........@@@@@@@@..............@
@....@@@@@@@@.....@@@@@@@..............@
@......@@@@@@@.......@@@....@@@@.......@
@.....@@@@@@@@@@@@..@@@@@@@@@..........@
@@@@@@@@@@@@@@@@@@@@@@@@@@@@@@@@@@@@@@@@